15 x 25
*************************
*   R +     *+*         *
*     * *     +         *
O                **     O
*   *     *             *
*     +    R R **       *
*   * R *      *        *
***      **          +* *
*              +**      *
*       +   H           O
*   R  **        ++     *
O               ***     *
*          *  **  R     *
*   *+                  *
*************************