10 x 20
**********O*********
*   R *     *+*    *
*     + *     *   **
*                  *
*  R +        H    *
*     *       +*   *
*   *  +      *    O
***      *+        *
*****           R  *
*************O******